NO ./textures/Abeille1.xpm
EA ./textures/Abeille2.xpm
SO ./textures/Abeille3.xpm
WE ./textures/Abeille4.xpm

F 191,245,255
C 255,170,0

111111111111111
100000000000001
100111000111001
100000000010001
100010010000001
100111000111001
100000010010001
100010E00000001
100111000111001
100000000000001
111111111111111