NO ./textures/galerie1.xpm
EA ./textures/galerie4.xpm
SO ./textures/galerie2.xpm
WE ./textures/galerie3.xpm

C 0,255,225
F 5,115,0

111111111111111111111
100001000000000100001
100000000010000000001
100001000000000100001
100000100000001000001
100000010000010000001
100000001000100000001
100000001000100000001
100000001000100000001
100000001000100000001
100000000101111111111
100000000100000000001
111111111111111111101
100000000000000000001
101111111111111111111
1000000000000000000W1
111111111111111111111
