NO ./textures/hammam1.xpm
EA ./textures/hammam2.xpm
SO ./textures/hammam3.xpm
WE ./textures/hammam4.xpm

F 191,245,255
C 255,170,0

111111111111111     1111
100000000000001     1001
1001110S0111001     1001
110000000000011     100111111
110000000000011     100000001
100111010111001     111111111
110000111000011
110001   100011
100000111000001
100000000000001
111111111111111