NO ./textures/hammam1.xpm
EA ./textures/hammam2.xpm
SO ./textures/hammam3.xpm
WE ./textures/hammam4.xpm

F 191,245,255
C 0,300,255

111111111111111
100000000000001
1001110S0111001
110000000000011
110000000000011
100111010111001
110000111000011
110001   100011
100000111000001
100000000000001
111111111111111