NO ./textures/Nature1.xpm
EA ./textures/Nature2.xpm
SO ./textures/Nature3.xpm
WE ./textures/Nature4.xpm

F 191,245,255

         11111111111111
         10000000000001
         10000000000001
1111111110000000N000001
10000000000001000000001
10000000000001000000001
10000000000000000000001
10000000000001000000001
10000000000001000000001
10000100000000000000001
10000100001111111100001
10000100001      100001
10000100001      100001
10000100001      100001
10000000001      100001
11111111111      111111