NO ./textures/galerie1.xpm
EA ./textures/galerie4.xpm
SO ./textures/galerie2.xpm
WE ./textures/galerie3.xpm

C 0,255,225
F 5,115,0

11111111111111111111
10000100000000100001
10000000000000000001
10000100000000100001
10000010000001000001
10000001000010000001
10000000100100000001
10000000100100000001
10000000100100000001
10000000100111111111
10000000010000000001
11111111111111111101
10000000000000000001
10111111111111111111
10000000000000000001
11111111111111111101
10000000000000000001
11111111111111111111